
1111111
1E10001
1000101
11C1111
1P00100
1111111


