1111111
1E100L1
10001C1
1110101
1P000C1
1111111
