

111111111111111
1C10000100000E1
101011010100001
100010000111111
1111101111000C1
1C0000010001111
1111110001000C1
100000010111001
1P1001C10000C11
111111111111111

