

111111111111111
1011P1E000000C1
100101000000001
110101000000001
100000000000001
100C00000000001
100000000000001
100000000000C01
111111111111111

